11111111111101111111111111
11111011111110111111111111
11111101111111011111111111
11111110111111101111111101
11111111011111110111111101
11111111101111111011111101
11111111110111111101111101
11111111111011111110111101
11111111111101111111011101
11111111111110111111101101
11111111111111011111110101
11111111111111101111101101
11101111111111110111101101
11010111111111101111101101
11011011111111011111101101
11011101111110111111101101
11011110111101111111101101
11011111011011111110011101
11011111010111111101111101
11100111101110000011111001
11111011111111111111111101
11111101111111111111101101
11111110111111111110011101
11111111011111111101111101
11111111100000000011111101
11111111111111111111111101