110000000000000000000000000000000000000
111111110111011111011101110111011111110
010001000001000001000101000001010000000
011101111101111111111111110101110111110
010001000000010101000100000101000001000
010111110101010101010111011111011111110
000100010101010000010001010001010101000
011101111111111111011101111101110101010
000001010001000001010101000000010001010
011111010101110101010101110111111101010
010001000100010100010101000000010000010
010111110111110111110111111101010111010
010000000000000000000101000001010100010
011101011111111101111101011111011111010
010001010101010000010000010100000100010
011101110101010111011111110101110111010
010001000000010100010001000100010101010
011111110101110111011101010101010101110
000001010101000101010001010001010001010
011101011101110101111101011111011111010
000100000000000100000001010000000000000
011101111101110101110111111111111111010
000101010000010001000100010001000100010
010101011111110101111101110101110101110
010101010100000101010101000100010001000
010111010101110111010101011101111111010
010100000000010001010001000100000100010
011111110101111101010101010111110111110
000000010101000101010100010001000001000
011111110111011101011101111101111111110
010000010001000000010000010001000100010
011101111111011111110111010111010101110
010001000000000100010001010001010001010
010111011111111101111101110111011111010
000100010000000101000001000000000000010
011101111111110101111101011101010111110
000000000000000000000000000000000000011