10001111111111101111000000
11011000000000101001000000
01000000000001101011000000
01111111111101001010111110
01000000000101111010100010
01011111010100000011100010
01010001010101111100011110
01010101010101000100010000
01010101110101000100010000
01011101010101001110110000
01000001010101001111111000
01111111010101010000001000
00000000000101011111111000
01111111111101000000001000
01000000010001111011111000
01011111010000001010000000
01010001010000001010111100
01010000011111101010100100
01011110010000101010100100
01000010010000101010100100
01000010010100101010100100
01000010010100101010100100
01011111110111101010100100
01000000000000001010110100
01111111111111111010000100
00000000000000000011111111