11000000000000000000000000000000000000000000000000000000000000000000000000000000000000000000000000000
11010111011101111101111111110111010111111101011111011101111111110111110111111111111101111101010111110
01010101000101010100000100000001010100010101000001010000000100000001000100010001000101000101010100010
01111101110111010101111101110101111111010101111111110111011111111111011101110111110111011101110101110
00010001000001010001000001000100000100000101010001010001000100000000000001000101010100010101010100010
01111101111101011111011111110111111101110101010111010111110111111111011111110101010111010111010101110
00000100000001000001010101000100010101000001000000010000010000010000000101000000000100000001000001000
01011111110111011111010101011111010101011111010111010101010111110101011101011111110111011111110101110
01010100000001000000010100000000010001000001010001010101010101000101000001000100010000010100000100010
01110101111101111101010111111111011101111111111101110111011101111111110111110101110111010101111111110
01000001000100010001000001000000010000000100000100010100000001010100000100000100010100000100010100000
01111111011101110101011101111101011101111101111111011101011101010111010111010111010111110111110111110
00000000010001000101010101010101000100010000010100000001000100010100010100010100010100000100000000010
01010111111111110111110101010111011101111101110111110101111111110101010111110101111101011111111111010
01010100000001000001010001010000010100010001000000000100000001010001010000000100000101000100010100010
01011111110111110111011101011111010111010101010111111101110111010111111101110111110111110111010111010
01000000010000010000010000000100010000010101010001000000010001010101000001000001010000010100000000010
01111111111101011111111111110111011111111101010111010111111111011101111111011111010101110101110111110
01000001000001000100000000010100000100000001010101010000000100010001000000000100000101010100010000000
01011111111101011101111111011101011101111101011101010111011101010111111101111101110111011111111111110
01010000010001010000000101000101010101000101010100010100010001000101010001000001000100010000000001010
01010101010111111101011101010101110111011101010111111101011111110101010111111111110111011101110111010
01010101000001000101010001010101000000000001010000010001010100000101000001000000000001000001000100010
01010101111101011101111101110101010101110101110111011101110111110101110101011111110101110111110101110
00000100010101000000000000010101010101000100010001000101010101000100000101000000010101000001010100010
01111111110101111111011111110101111111111111011111010101010101011111111101011111110111011101010111010
00000100010001010000000100000100010100000100010000010100000000000100000100000101000101010000010001000
01011101011101010101110111011111110101011111011101110111110111110101111111011101111101011101110101110
01010001000100010101000100000100000001000000000100010001000100000000010100010100000101010001000100000
01110111110111011101111111011111011101110101010111011101110101110101110111110111110101111111011101110
01010001000100010101000000010000010100010101010101000101000101000101000100000101010101010100010001000
01011101010111110111010111011111110101111101011101011101111111010111011111110101010101010101111111110
00000101010100000100010100010000000000010001010001010100000101010100000100010000010100000100000001000
01011111011111110101111101111111110101011111010111010101111101111111011111010111110111011101111111110
01000101010100000101010000010000010101010101000001000101010001010100010001000001010000000101010100000
01111101010111011111011111011111011111010101111111011111010111010111011101011111011101111111010111110
00000000000000000000000000000000000000000000000000000000000000000000000000000000000000000000000000011